8 8
0 0
6 7
__7__7_7
7|||_||7
|*_*__||
*_7|_7||
|*_||__|
*___*7||
7|*___|7
*_|_*__|